1 1 1 1 1 1 1 1 1 1 1 1 1 1 1 1 1 1 1 1 1 1 1 1 1 1 1 1 1 1
1 0 0 0 0 0 0 0 0 0 0 0 0 0 0 0 0 0 0 0 0 0 0 0 0 0 0 0 0 1
1 0 9 9 0 0 9 9 0 0 9 9 0 0 2 2 2 2 2 2 2 9 9 9 9 9 9 5 0 1
1 0 3 3 0 0 0 0 0 0 0 0 0 0 2 0 4 9 0 0 0 0 0 0 0 0 0 9 0 1
1 0 9 9 0 0 9 9 0 0 9 9 0 0 2 0 0 9 0 9 9 9 9 9 9 9 0 9 0 1
1 0 0 0 0 0 0 0 0 0 0 0 0 0 2 0 0 9 0 9 0 0 0 0 0 9 0 9 0 1
1 1 1 1 1 1 9 9 1 1 1 1 1 1 2 1 1 1 1 9 0 9 9 9 0 9 0 9 0 1
1 0 0 0 0 0 0 0 0 0 0 0 0 0 2 0 0 0 0 9 0 9 0 9 0 9 0 5 0 1
1 0 9 9 9 9 9 0 9 9 9 9 0 0 2 0 0 0 0 9 0 9 0 9 0 9 0 9 0 1
1 0 0 0 0 0 9 0 0 0 0 0 0 0 2 0 0 0 0 9 0 9 0 9 0 9 0 9 0 1
1 0 9 9 9 0 9 0 9 9 9 9 9 9 2 9 9 9 9 9 0 9 9 9 0 5 9 9 0 1
1 4 0 0 0 0 9 0 0 3 0 0 0 0 2 0 0 0 0 0 0 0 0 0 0 0 0 0 3 1
1 1 1 1 1 1 1 1 1 1 1 1 1 1 1 1 1 1 1 1 1 1 1 1 1 1 1 1 1 1
