1 1 1 1 1 1 1 1 1 1 1 1 1 1 1 1 1 1 1 1 1 1 1 1 1 1 1 1 1 1 1 1 1 1 1 1 1 1 1 1 1 1 1 1 1 1 1 1 1 1
1 9 9 9 9 9 9 9 9 9 9 9 9 9 9 9 9 9 9 9 9 9 9 9 2 9 9 9 9 9 9 9 9 9 9 9 9 9 9 9 9 9 9 9 9 9 9 9 9 1
1 9 5 5 5 5 5 5 5 5 5 5 5 5 5 5 5 5 5 5 5 5 5 5 2 5 5 5 5 5 5 5 5 5 5 5 5 5 5 5 5 5 5 5 5 5 5 5 9 1
1 9 5 9 9 9 9 9 9 9 9 9 9 9 9 9 9 9 9 9 9 9 9 9 2 9 9 9 9 9 9 9 9 9 9 9 9 9 9 9 9 9 9 9 9 9 9 5 9 1
1 9 5 9 0 0 0 0 0 0 0 0 0 0 0 0 0 0 0 0 0 0 0 0 2 0 0 0 0 0 0 0 0 0 0 0 0 0 0 0 0 0 0 0 0 0 0 5 9 1
1 9 5 9 0 9 9 9 9 9 9 9 9 9 9 9 9 9 9 9 9 9 9 9 2 9 9 9 9 9 9 9 9 9 9 9 9 9 9 9 9 9 9 9 9 9 0 5 9 1
1 9 5 9 0 9 0 0 0 0 0 0 0 0 0 0 0 0 0 0 0 0 0 0 2 0 0 0 0 0 0 0 0 0 0 0 0 0 0 0 0 0 0 0 0 9 0 5 9 1
1 9 5 9 0 9 0 9 9 9 9 9 9 9 9 9 9 9 9 9 9 9 9 9 2 9 9 9 9 9 9 9 9 9 9 9 9 9 9 9 9 9 9 9 0 9 0 5 9 1
1 9 5 9 0 9 0 9 0 0 0 0 0 0 0 0 0 0 0 0 0 0 0 0 2 0 0 0 0 0 0 0 0 0 0 0 0 0 0 0 0 0 0 9 0 9 0 5 9 1
1.9 5 9 0 9 0 9 0 9 9 9 9 9 9 9 9 9 9 9 9 9 9 9 9 2 9 9 9 9 9 9 9 9 9 9 9 9 9 9 9 9 9 0 9 0 9 0 5 9 1
1 9 5 9 0 9 0 9 0 9 0 0 0 0 0 0 0 0 0 0 0 0 0 0 0 0 0 0 0 0 0 0 0 0 0 0 0 0 0 0 0 9 0 9 0 9 0 5 9 1
1 9 5 9 0 9 0 9 0 9 0 9 9 9 9 9 9 9 9 9 9 9 9 9 9 9 9 9 9 9 9 9 9 9 9 9 9 9 9 9 0 9 0 9 0 9 0 5 9 1
1 9 5 9 0 9 0 9 0 9 0 9 0 0 0 0 0 0 0 0 0 0 0 0 0 0 0 0 0 0 0 0 0 0 0 0 0 0 0 9 0 9 0 9 0 9 0 5 9 1
1 9 5 9 0 9 0 9 0 9 0 9 0 9 9 9 9 9 9 9 9 9 9 9 9 9 9 9 9 9 9 9 9 9 9 9 9 9 0 9 0 9 0 9 0 9 0 5 9 1
1 9 5 9 0 9 0 9 0 9 0 9 0 9 0 0 0 0 0 0 0 0 0 0 0 0 0 0 0 0 0 0 0 0 0 0 0 9 0 9 0 9 0 9 0 9 0 5 9 1
1 9 5 9 0 9 0 9 0 9 0 9 0 9 0 9 9 9 9 9 9 9 9 9 9 9 9 9 9 9 9 9 9 9 9 9 0 9 0 9 0 9 0 9 0 9 0 5 9 1
1 9 5 9 0 9 0 9 0 9 0 9 0 9 0 9 0 0 0 0 0 0 0 0 0 0 0 0 0 0 0 0 0 0 0 9 0 9 0 9 0 9 0 9 0 9 0 5 9 1
1 9 5 9 0 9 0 9 0 9 0 9 0 9 0 9 0 9 9 9 9 9 9 9 9 9 9 9 9 9 9 9 9 9 0 9 0 9 0 9 0 9 0 9 0 9 0 5 9 1
1 9 5 9 0 9 0 9 0 9 0 9 0 9 0 9 0 9 0 0 0 0 0 0 0 0 0 0 0 0 0 0 0 9 0 9 0 9 0 9 0 9 0 9 0 9 0 5 9 1
1 9 5 9 0 9 0 9 0 9 0 9 0 9 0 9 0 9 0 9 9 9 9 9 9 9 9 9 9 9 9 9 0 9 0 9 0 9 0 9 0 9 0 9 0 9 0 5 9 1
1 9 2 2 2 2 2 2 2 9 0 9 0 9 0 9 0 9 0 9 0 0 0 0 0 0 0 0 0 9 0 9 0 9 0 9 0 9 0 9 0 9 0 9 0 9 0 2 2 1
1 9 9 9 9 9 9 9 9 9 0 9 0 9 0 9 0 9 0 9 9 9 9 9 9 9 9 9 9 9 0 9 0 9 0 9 0 9 0 9 0 9 0 9 0 9 9 9 9 1
1 5 0 0 0 0 0 0 0 0 0 9 0 9 0 9 0 9 0 0 0 0 0 0 0 0 0 0 0 0 0 9 0 9 0 9 0 9 0 9 0 9 0 9 0 0 0 0 5 1
1 5 9 9 9 9 9 9 9 9 9 9 0 9 0 9 0 9 9 9 9 9 9 9 9 9 9 9 9 9 9 9 0 9 0 9 0 9 0 9 0 9 0 9 9 9 9 9 5 1
1 5 9 0 0 0 0 0 0 0 0 0 0 9 0 9 0 0 0 0 0 0 0 0 0 0 0 0 0 0 0 9 0 9 0 9 0 9 0 9 0 9 0 0 0 0 0 9 5 1
1 5 9 0 9 9 9 9 9 9 9 9 9 9 0 9 9 9 9 9 9 9 9 9 9 9 9 9 9 9 9 9 0 9 0 9 0 9 0 9 0 9 9 9 9 9 0 9 5 1
1 5 9 0 9 0 0 0 0 0 0 0 0 0 0 9 0 0 0 0 0 0 0 0 0 0 0 0 0 0 0 9 0 9 0 9 0 9 0 9 0 0 0 0 0 9 0 9 5 1
1 5 9 0 9 0 9 9 9 9 9 9 9 9 9 9 0 9 9 9 9 9 9 9 9 9 9 9 9 9 0 9 0 9 0 9 0 9 0 9 9 9 9 9 0 9 0 9 5 1
1 5 9 0 9 0 9 0 0 0 0 0 0 0 0 0 0 9 0 0 0 0 0 0 0 0 0 0 0 9 0 9 0 9 0 9 0 9 0 0 0 0 0 9 0 9 0 9 5 1
1 5 9 0 9 0 9 0 9 9 9 9 9 9 9 9 9 9 0 9 9 9 9 9 9 9 9 9 0 9 0 9 0 9 0 9 0 9 9 9 9 9 0 9 0 9 0 9 5 1
1 5 9 0 9 0 9 0 9 0 0 0 0 0 0 0 0 0 0 9 0 0 0 0 0 0 0 9 0 9 0 9 0 9 0 9 0 0 0 0 0 9 0 9 0 9 0 9 5 1
1 5 9 0 9 0 9 0 9 0 9 9 9 9 9 9 9 9 9 9 0 9 9 9 9 9 0 9 0 9 0 9 0 9 0 9 9 9 9 9 0 9 0 9 0 9 0 9 5 1
1 5 9 0 9 0 9 0 9 0 9 0 0 0 0 0 0 0 0 0 0 9 0 0 0 9 0 9 0 9 0 9 0 9 0 0 0 0 0 9 0 9 0 9 0 9 0 9 5 1
1 5 9 0 9 0 9 0 9 0 9 0 9 9 9 9 9 9 9 9 9 9 0 9 0 9 0 9 0 9 0 9 0 9 9 9 9 9 0 9 0 9 0 9 0 9 0 9 5 1
1 5 9 0 9 0 9 0 9 0 9 0 9 0 0 0 0 0 0 0 0 0 0 9 0 9 0 9 0 9 0 9 0 0 0 0 0 9 0 9 0 9 0 9 0 9 0 9 5 1
1 5 9 0 9 0 9 0 9 0 9 0 9 0 9 9 9 9 9 9 9 9 9 9 0 9 0 9 0 9 0 9 9 9 9 9 0 9 0 9 0 9 0 9 0 9 0 9 5 1
1 5 9 0 9 0 9 0 9 0 9 0 9 0 9 0 0 0 0 0 0 0 0 0 0 9 0 9 0 9 0 0 0 0 0 9 0 9 0 9 0 9 0 9 0 9 0 9 5 1
1 5 9 0 9 0 9 0 9 0 9 0 9 0 9 0 9 9 9 9 9 9 9 9 9 9 0 9 0 9 9 9 9 9 0 9 0 9 0 9 0 9 0 9 0 9 0 9 5 1
1 5 9 0 9 0 9 0 9 0 9 0 9 0 9 0 9 0 0 0 0 0 0 0 0 0 0 9 0 0 0 0 0 9 0 9 0 9 0 9 0 9 0 9 0 9 0 9 5 1
1 5 9 0 9 0 9 0 9 0 9 0 9 0 9 0 9 0 9 9 9 9 9 9 9 9 9 9 9 9 9 9 0 9 0 9 0 9 0 9 0 9 0 9 0 9 0 9 5 1
1 5 9 0 9 0 9 0 9 0 9 0 9 0 9 0 9 0 9 0 0 0 0 0 0 0 0 0 0 0 0 9 0 9 0 9 0 9 0 9 0 9 0 9 0 9 0 9 5 1
1 5 9 0 9 0 9 0 9 0 9 0 9 0 9 0 9 0 9 0 9 9 9 9 9 9 9 9 9 9 0 9 0 9 0 9 0 9 0 9 0 9 0 9 0 9 0 9 5 1
1 5 9 0 9 0 9 0 9 0 9 0 9 0 9 0 9 0 9 0 9 0 0 0 0 0 0 0 0 9 0 9 0 9 0 9 0 9 0 9 0 9 0 9 0 9 0 9 5 1
1 5 9 0 9 0 9 0 9 0 9 0 9 0 9 0 9 0 9 0 9 0 9 9 9 9 9 9 0 9 0 9 0 9 0 9 0 9 0 9 0 9 0 9 0 9 0 9 5 1
1 5 9 0 9 0 9 0 9 0 9 0 9 0 9 0 9 0 9 0 9 0 9 0 0 0 0 9 0 9 0 9 0 9 0 9 0 9 0 9 0 9 0 9 0 9 0 9 5 1
1 5 9 0 9 0 9 0 9 0 9 0 9 0 9 0 9 0 9 0 9 0 9 0 9 9 0 9 0 9 0 9 0 9 0 9 0 9 0 9 0 9 0 9 0 9 0 9 5 1
1 5 9 0 9 0 9 0 9 0 9 0 9 0 9 0 9 0 9 0 9 0 9 0 9 4 0 9 0 9 0 9 0 9 0 9 0 9 0 9 0 9 0 9 0 9 0 9 5 1
1 5 9 0 9 0 9 0 9 0 9 0 9 0 9 0 9 0 9 0 9 0 9 0 9 9 0 9 0 9 0 9 0 9 0 9 0 9 0 9 0 9 0 9 0 9 0 9 5 1
1 5 9 0 9 0 9 0 9 0 9 0 9 0 9 0 9 0 9 0 9 0 9 0 0 0 0 9 0 9 0 9 0 9 0 9 0 9 0 9 0 9 0 9 0 9 0 9 5 1
1 5 9 0 9 0 9 0 9 0 9 0 9 0 9 0 9 0 9 0 9 0 9 9 9 9 9 9 0 9 0 9 0 9 0 9 0 9 0 9 0 9 0 9 0 9 0 9 5 1
1 5 9 0 9 0 9 0 9 0 9 0 9 0 9 0 9 0 9 0 9 0 0 0 0 0 0 0 0 9 0 9 0 9 0 9 0 9 0 9 0 9 0 9 0 9 0 9 5 1
1 5 9 0 9 0 9 0 9 0 9 0 9 0 9 0 9 0 9 0 9 9 9 9 9 9 9 9 9 9 0 9 0 9 0 9 0 9 0 9 0 9 0 9 0 9 0 9 5 1
1 5 9 0 9 0 9 0 9 0 9 0 9 0 9 0 9 0 9 0 0 0 0 0 0 0 0 0 0 0 0 9 0 9 0 9 0 9 0 9 0 9 0 9 0 9 0 9 5 1
1 5 9 0 9 0 9 0 9 0 9 0 9 0 9 0 9 0 9 0 9 9 9 9 9 9 9 9 9 9 9 9 0 9 0 9 0 9 0 9 0 9 0 9 0 9 0 9 5 1
1 5 9 0 9 0 9 0 9 0 9 0 9 0 9 0 9 0 9 0 9 0 0 0 0 0 0 0 0 0 0 9 0 9 0 9 0 9 0 9 0 9 0 9 0 9 0 9 5 1
1 5 9 0 9 0 9 0 9 0 9 0 9 0 9 0 9 0 9 0 9 0 9 9 9 9 9 9 9 9 9 9 0 9 0 9 0 9 0 9 0 9 0 9 0 9 0 9 5 1
1 5 9 0 9 0 9 0 9 0 9 0 9 0 9 0 9 0 9 0 9 0 9 0 0 0 0 0 0 0 0 9 0 9 0 9 0 9 0 9 0 9 0 9 0 9 0 9 5 1
1 5 9 0 9 0 9 0 9 0 9 0 9 0 9 0 9 0 9 0 9 0 9 0 9 9 9 9 9 9 9 9 0 9 0 9 0 9 0 9 0 9 0 9 0 9 0 9 5 1
1 5 9 0 9 0 9 0 9 0 9 0 9 0 9 0 9 0 9 0 9 0 9 0 9 0 0 0 0 0 0 9 0 9 0 9 0 9 0 9 0 9 0 9 0 9 0 9 5 1
1 5 9 0 9 0 9 0 9 0 9 0 9 0 9 0 9 0 9 0 9 0 9 0 9 0 9 9 9 9 9 9 0 9 0 9 0 9 0 9 0 9 0 9 0 9 0 9 5 1
1 5 9 0 9 0 9 0 9 0 9 0 9 0 9 0 9 0 9 0 9 0 9 0 9 0 9 0 0 0 0 9 0 9 0 9 0 9 0 9 0 9 0 9 0 9 0 9 5 1
1 5 9 0 9 0 9 0 9 0 9 0 9 0 9 0 9 0 9 0 9 0 9 0 9 0 9 0 9 9 9 9 0 9 0 9 0 9 0 9 0 9 0 9 0 9 0 9 5 1
1 5 9 0 9 0 9 0 9 0 9 0 9 0 9 0 9 0 9 0 9 0 9 0 9 0 9 0 9 0 0 0 0 9 0 9 0 9 0 9 0 9 0 9 0 9 0 9 5 1
1 5 9 0 9 0 9 0 9 0 9 0 9 0 9 0 9 0 9 0 9 0 9 0 9 0 9 0 9 0 9 9 9 9 0 9 0 9 0 9 0 9 0 9 0 9 0 9 5 1
1 5 9 0 9 0 9 0 9 0 9 0 9 0 9 0 9 0 9 0 9 0 9 0 9 0 9 0 9 0 9 0 0 0 0 9 0 9 0 9 0 9 0 9 0 9 0 9 5 1
1 5 9 0 9 0 9 0 9 0 9 0 9 0 9 0 9 0 9 0 9 0 9 0 9 0 9 0 9 0 9 0 9 9 9 9 0 9 0 9 0 9 0 9 0 9 0 9 5 1
1 5 9 0 9 0 9 0 9 0 9 0 9 0 9 0 9 0 9 0 9 0 9 0 9 0 9 0 9 0 9 0 9 0 0 0 0 9 0 9 0 9 0 9 0 9 0 9 5 1
1 5 9 0 9 0 9 0 9 0 9 0 9 0 9 0 9 0 9 0 9 0 9 0 9 0 9 0 9 0 9 0 9 0 9 9 9 9 0 9 0 9 0 9 0 9 0 9 5 1
1 5 9 0 9 0 9 0 9 0 9 0 9 0 9 0 9 0 9 0 9 0 9 0 9 0 9 0 9 0 9 0 9 0 9 0 0 0 0 9 0 9 0 9 0 9 0 9 5 1
1 5 9 0 9 0 9 0 9 0 9 0 9 0 9 0 9 0 9 0 9 0 9 0 9 0 9 0 9 0 9 0 9 0 9 0 9 9 9 9 0 9 0 9 0 9 0 9 5 1
1 5 9 0 9 0 9 0 9 0 9 0 9 0 9 0 9 0 9 0 9 0 9 0 9 0 9 0 9 0 9 0 9 0 9 0 9 0 0 0 0 9 0 9 0 9 0 9 5 1
1 5 9 0 9 0 9 0 9 0 9 0 9 0 9 0 9 0 9 0 9 0 9 0 9 0 9 0 9 0 9 0 9 0 9 0 9 0 9 9 9 9 0 9 0 9 0 9 5 1
1 5 9 0 9 0 9 0 9 0 9 0 9 0 9 0 9 0 9 0 9 0 9 0 9 0 9 0 9 0 9 0 9 0 9 0 9 0 9 0 0 0 0 9 0 9 0 9 5 1
1 5 9 0 9 0 9 0 9 0 9 0 9 0 9 0 9 0 9 0 9 0 9 0 9 0 9 0 9 0 9 0 9 0 9 0 9 0 9 0 9 9 9 9 0 9 0 9 5 1
1 5 9 0 9 0 9 0 9 0 9 0 9 0 9 0 9 0 9 0 9 0 9 0 9 0 9 0 9 0 9 0 9 0 9 0 9 0 9 0 9 0 0 0 0 9 0 9 5 1
1 5 9 0 9 0 9 0 9 0 9 0 9 0 9 0 9 0 9 0 9 0 9 0 9 0 9 0 9 0 9 0 9 0 9 0 9 0 9 0 9 0 9 9 9 9 0 9 5 1
1 2 2 2 2 2 2 2 2 9 0 9 0 9 0 9 0 9 0 9 0 9 0 9 0 9 0 9 0 9 0 9 0 9 0 9 0 9 0 9 0 9 0 9 0 9 0 2 2 1
1 9 9 9 9 9 9 9 9 9 0 9 0 9 0 9 0 9 0 9 9 9 9 9 9 9 9 9 9 9 0 9 0 9 0 9 0 9 0 9 0 9 0 9 0 9 9 9 9 1
1 5 0 0 0 0 0 0 0 0 0 9 0 9 0 9 0 9 0 0 0 0 0 0 0 0 0 0 0 0 0 9 0 9 0 9 0 9 0 9 0 9 0 9 0 0 0 0 5 1
1 5 9 9 9 9 9 9 9 9 9 9 0 9 0 9 0 9 9 9 9 9 9 9 9 9 9 9 9 9 9 9 0 9 0 9 0 9 0 9 0 9 0 9 9 9 9 9 5 1
1 5 9 0 0 0 0 0 0 0 0 0 0 9 0 9 0 0 0 0 0 0 0 0 0 0 0 0 0 0 0 9 0 9 0 9 0 9 0 9 0 9 0 0 0 0 0 9 5 1
1 5 9 0 9 9 9 9 9 9 9 9 9 9 0 9 9 9 9 9 9 9 9 9 9 9 9 9 9 9 9 9 0 9 0 9 0 9 0 9 0 9 9 9 9 9 0 9 5 1
1 5 9 0 9 0 0 0 0 0 0 0 0 0 0 9 0 0 0 0 0 0 0 0 0 0 0 0 0 0 0 9 0 9 0 9 0 9 0 9 0 0 0 0 0 9 0 9 5 1
1 1 1 1 1 1 1 1 1 1 1 1 1 1 1 1 1 1 1 1 1 1 1 1 1 1 1 1 1 1 1 1 1 1 1 1 1 1 1 1 1 1 1 1 1 1 1 1 1 1