1 1 1 1 1 1 1 1 1 1 1 1 1 1 1 1 1 1 1 1 1 1 1 1 1
1 5 5 9 9 9 9 9 9 9 9 2 2 9 9 9 9 9 9 9 9 9 5 5 1
1 5 9 9 0 0 0 0 0 0 9 2 2 9 0 0 0 0 0 0 0 9 9 5 1
1 9 9 0 0 9 9 9 9 0 9 2 2 9 0 9 9 9 9 9 0 0 9 9 1
1 9 0 0 9 9 4 4 4 0 0 2 2 0 0 4 4 4 9 9 0 0 0 9 1
1 9 0 0 9 4 4 4 4 9 0 2 2 0 9 4 4 4 4 9 0 0 0 9 1
1 9 0 0 9 9 9 9 9 9 0 2 2 0 9 9 9 9 9 9 0 0 0 9 1
1 2 2 2 2 2 2 2 2 2 2 2 3 2 2 2 2 2 2 2 2 2 2 2 1
1 2 4 9 9 9 9 9 9 9 4 2 3 2 4 9 9 9 9 9 9 9 4 2 1
1 2 0 0 0 0 0 0 0 0 0 2 3 2 0 0 0 0 0 0 0 0 0 2 1
1 2 0 9 9 9 9 9 9 9 9 2 9 2 9 9 9 9 9 9 9 9 0 2 1
1 2 0 9 0 0 0 0 0 0 9 2 9 2 9 0 0 0 0 0 0 9 0 2 1
1 2 0 9 0 9 9 9 9 0 9 2 9 2 9 0 9 9 9 9 0 9 0 2 1
1 2 3 9 0 9 0 0 9 0 9 2 9 2 9 0 9 0 0 9 0 9 3 2 1
1 2 2 2 0 9 0 0 9 0 2 2 9 2 2 0 9 0 0 9 0 2 2 2 1
1 9 9 2 0 9 0 0 9 0 2 9 9 9 2 0 9 0 0 9 0 2 9 9 1
1 5 9 2 0 9 9 9 9 0 2 3 3 3 2 0 9 9 9 9 0 2 9 5 1
1 9 9 2 0 0 0 0 0 0 2 2 2 2 2 0 0 0 0 0 0 2 9 9 1
1 9 0 2 2 2 2 2 2 2 2 9 9 9 2 2 2 2 2 2 2 2 0 9 1
1 9 0 9 9 9 9 9 9 9 2 9 4 9 2 9 9 9 9 9 9 9 0 9 1
1 9 0 0 0 0 0 0 0 9 2 9 4 9 2 9 0 0 0 0 0 0 0 9 1
1 9 9 9 9 9 9 9 0 9 2 9 4 9 2 9 0 9 9 9 9 9 9 9 1
1 0 0 0 0 0 0 9 3 2 2 9 4 9 2 2 3 9 0 0 0 0 0 0 1
1 0 9 9 9 9 9 9 9 2 9 9 4 9 9 2 9 9 9 9 9 9 9 0 1
1 0 9 4 4 4 4 4 9 2 9 4 4 4 9 2 9 4 4 4 4 4 9 0 1
1 0 9 9 9 9 9 9 9 2 9 9 9 9 9 2 9 9 9 9 9 9 9 0 1
1 0 0 0 0 0 0 0 0 2 0 0 0 0 0 2 0 0 0 0 0 0 0 0 1
1 9 9 9 9 9 9 9 9 2 9 9 9 9 9 2 9 9 9 9 9 9 9 9 1
1 0 0 0 0 0 0 0 9 2 9 0 0 0 9 2 9 0 0 0 0 0 0 0 1
1 0 9 9 9 9 9 0 9 2 9 0 9 0 9 2 9 0 9 9 9 9 9 0 1
1 0 9 4 4 4 9 0 9 2 9 0 9 0 9 2 9 0 9 4 4 4 9 0 1
1 0 9 9 9 9 9 3 9 2 9 3 9 3 9 2 9 3 9 9 9 9 9 0 1
1 0 0 0 0 0 0 0 9 2 9 9 9 9 9 2 9 0 0 0 0 0 0 0 1
1 9 9 9 9 9 9 9 9 2 2 2 2 2 2 2 9 9 9 9 9 9 9 9 1
1 9 4 4 4 4 4 4 9 9 9 9 9 9 9 9 9 4 4 4 4 4 4 9 1
1 9 9 9 9 9 9 4 9 0 0 0 0 0 0 0 9 4 9 9 9 9 9 9 1
1 0 0 0 0 0 9 4 9 0 9 9 9 9 9 0 9 4 9 0 0 0 0 0 1
1 0 9 9 9 0 9 4 9 0 9 5 5 5 9 0 9 4 9 0 9 9 9 0 1
1 0 9 5 9 0 9 4 9 0 9 5 9 5 9 0 9 4 9 0 9 5 9 0 1
1 0 9 9 9 0 9 4 9 0 9 5 5 5 9 0 9 4 9 0 9 9 9 0 1
1 0 0 0 0 0 9 4 9 0 9 9 9 9 9 0 9 4 9 0 0 0 0 0 1
1 9 9 9 9 9 9 4 9 0 0 0 0 0 0 0 9 4 9 9 9 9 9 9 1
1 9 4 4 4 4 4 4 9 9 9 9 9 9 9 9 9 4 4 4 4 4 4 9 1
1 2 2 2 2 2 2 2 2 2 2 2 2 2 2 2 2 2 2 2 2 2 2 2 1
1 2 9 9 9 9 9 9 9 9 9 9 4 9 9 9 9 9 9 9 9 9 9 2 1
1 2 9 0 0 0 0 0 0 0 0 0 0 0 0 0 0 0 0 0 0 0 9 2 1
1 2 9 0 9 9 9 9 9 9 9 9 2 9 9 9 9 9 9 9 9 0 9 2 1
1 2 9 0 9 0 0 0 0 0 0 9 2 9 0 0 0 0 0 0 0 0 9 2 1
1 2 9 0 9 0 9 9 9 9 0 9 2 9 0 9 9 9 9 9 9 0 9 2 1
1 2 9 0 9 0 9 0 0 9 0 9 2 9 0 9 0 0 0 9 0 0 9 2 1
1 2 3 3 9 0 9 0 0 9 0 9 2 9 0 9 0 9 0 9 0 3 3 2 1
1 2 9 9 9 0 9 0 0 9 0 9 2 9 0 9 0 9 0 9 0 9 9 2 1
1 2 0 0 0 0 9 0 0 9 0 0 2 0 0 9 0 9 0 0 0 0 0 2 1
1 2 9 9 9 9 9 9 9 9 9 9 2 9 9 9 9 9 9 9 9 9 9 2 1
1 2 0 0 0 0 0 0 0 0 0 0 2 0 0 0 0 0 0 0 0 0 0 2 1
1 2 2 2 2 2 2 2 2 2 2 2 2 2 2 2 2 2 2 2 2 2 2 2 1
1 9 9 9 9 9 9 9 9 9 9 9 4 9 9 9 9 9 9 9 9 9 9 9 1
1 0 0 0 0 0 0 0 0 0 9 0 0 0 9 0 0 0 0 0 0 0 0 0 1
1 0 9 9 9 9 9 9 9 0 9 0 9 0 9 0 9 9 9 9 9 9 9 0 1
1 0 9 0 0 0 0 0 9 0 9 0 9 0 9 0 9 0 0 0 0 0 9 0 1
1 0 9 0 9 9 9 0 9 0 9 0 9 0 9 0 9 0 9 9 9 0 9 0 1
1 0 9 0 9 4 9 0 9 3 9 3 9 3 9 3 9 0 9 4 9 0 9 0 1
1 0 9 0 9 9 9 0 9 0 9 0 9 0 9 0 9 0 9 9 9 0 9 0 1
1 0 9 0 0 0 0 0 9 0 9 0 9 0 9 0 9 0 0 0 0 0 9 0 1
1 0 9 9 9 9 9 9 9 0 9 0 9 0 9 0 9 9 9 9 9 9 9 0 1
1 0 0 0 0 0 0 0 0 0 9 0 0 0 9 0 0 0 0 0 0 0 0 0 1
1 9 9 9 9 9 9 9 9 9 9 9 9 9 9 9 9 9 9 9 9 9 9 9 1
1 0 0 0 0 0 0 0 0 0 0 0 0 0 0 0 0 0 0 0 0 0 0 0 1
1 9 9 9 9 9 9 9 9 9 9 0 0 0 9 9 9 9 9 9 9 9 9 9 1
1 0 0 0 0 0 0 0 0 0 9 0 2 0 9 0 0 0 0 0 0 0 0 0 1
1 9 9 9 9 9 9 9 9 0 9 0 2 0 9 0 9 9 9 9 9 9 9 9 1
1 0 0 0 0 0 0 0 9 0 9 0 2 0 9 0 9 0 0 0 0 0 0 0 1
1 9 9 9 9 9 9 0 9 0 9 0 2 0 9 0 9 0 9 9 9 9 9 9 1
1 0 0 0 0 0 9 0 0 0 9 0 2 0 9 0 0 0 9 0 0 0 0 0 1
1 9 9 9 9 0 9 9 9 9 9 3 2 3 9 9 9 9 9 0 9 9 9 9 1
1 1 1 1 1 1 1 1 1 1 1 1 2 1 1 1 1 1 1 1 1 1 1 1 1